111111111*
111211111*
111211111*
111211111*
111212111*
121111121*
121112111*
121112111*
111112111*
112111121*
211112111*
?
.........*
.p.......*
.........*
.......t.*
.........*
.........*
....t....*
.........*
..t......*
.........*
.........*



