111111 ......*
111111 ......*
111111 ......*
222222 ......*
222222 ......*
222222 ......*
?
p..... ......*
...... ......*
...... ......*
...... ......*
...... ......*
..tttt ..<>^v*
